####################
____#####___________
#__________________#
#__________________#
#__________________#
#__________________#
#__________________#
#________#_________#
#________#_________#
#________#_________#
#________#_________#
#________#_________#
#__##############__#
#__________________#
#__________________#
#__________________#
#__________________#
#_________###______#
#__________________#
####################