####################
#__________________#
#________#_________#
#________#_________#
_________#__________
#________#_________#
#________#_________#
#________#_________#
#__________________#
#__________________#
#__________________#
#__________________#
#________#_________#
#________#_________#
#________#_________#
#________#_________#
#________#_________#
#________#_________#
#__________________#
####################