####################
#__________________#
#__________________#
#__________________#
____________________
#__________________#
#__________________#
#__________________#
#__________________#
#__________________#
#__________________#
#__________________#
#__________________#
#__________________#
#__________________#
#__________________#
#__________________#
#__________________#
#__________________#
####################